1000000000000000000000000000
1000000000000000000000000000
1000000000000000000000000000
1000000000000000000000000000
1000000000000000000000000000
1000000000000000100000000000
1000000000000000100000000000
1000010000000000100000000000
1000000000b00000100000000000
1111111111111111111111111111