1000000000000000000000000000
1000000000000000000000000000
1000000000000000000000000000
1000000000000000000000000000
1000000000000000000000000000
1000000000000000100000000000
10000000000b0000100000000000
10000111000bb000100000000000
1000000000bbb000100000000000
1111111111111111111111111111